WiiChuck	KEYWORD1

begin	KEYWORD2
readData	KEYWORD2
addMultiplexer	KEYWORD2
getJoyX	KEYWORD2
getJoyY	KEYWORD2
getRollAngle	KEYWORD2
getPitchAngle	KEYWORD2
getAccelX	KEYWORD2
getAccelY	KEYWORD2
getAccelZ	KEYWORD2
checkButtonC	KEYWORD2
checkButtonZ	KEYWORD2

SDA	LITERAL1
SCL	LITERAL1
SDA1	LITERAL1
SCL1	LITERAL1

NUNCHUCK	LITERAL2
WIICLASSIC	LITERAL2
GuitarHeroController	LITERAL2
GuitarHeroWorldTourDrums	LITERAL2
DrumController	LITERAL2
DrawsomeTablet	LITERAL2
Mystery	LITERAL2
